###s###
#     #
#     #
# *****
#   R #
# *****
###T###
