*s*******
*       *
******* *
*       *
* *******
*       *
******* *
*       *
* *******
*       T
*********
