***s***
*     *
* *** *
* *** *
* *** *
* *** *
* *   *
***T***
