******s******
****** ******
****** ******
****** ******
****** ******
****** ******
T           t
*************
