******s******
****** ******
****** ******
****** ******
****** ******
****** ******
T        t***
*************
