****s*******
**** *******
**** *******
****      R#
**** ***** #
**** ***** #
**** ***** #
**** ***** #
****       #
****T*******
