###S###
#     #
#     #
# *****
#     #
#     #
###T###