***S***
*** ***
*** ***
*** ***
*** ***
*** ***
R     T
*******