##rs###
#   r #
# R   #
#   r #
# R   #
#   r #
###T###
