###s###
#     #
#     #
#     #
#     #
#     #
###T###
