***S***
*** ***
*** ***
R     #
#*****#
#*****#
#     #
***T***