***s***
*** ***
*** ***
R     r
#     #
#     #
#     #
***T***
