###s###
#     #
#     #
# *****
#     #
# *****
###T###
