##rs###
#   R #
# R   #
#   r #
# r   #
#   R #
###T###
