###S###
#R    #
#    R#
#R    #
#    R#
#R    #
#     #
#     #
#     #
###T###