###S###
#     #
#     #
#     #
#     #
#     #
###T###