##RS###
#   R #
# R   #
#   R #
# R   #
#   R #
###T###