#####s#####
#       r #
# R       #
#       r #
# R       #
#       r #
#       r #
#       r #
#####T#####
