#####s#
#     #
#     #
# *****
#     #
#     #
#####T#
